tech.gmw.cn	光明网
theory.gmw.cn	光明网
news.gmw.cn	光明网
world.gmw.cn	光明网
legal.gmw.cn	光明网
topics.gmw.cn	光明网
economy.gmw.cn	光明网
politics.gmw.cn	光明网
guancha.gmw.cn	光明网
dangjian.gmw.cn	光明网
www.gmw.cn	光明网
news.xinhuanet.com	新华网
www.xinhuanet.com	新华网
www.banyuetan.org	新华网
jhsjk.people.cn	习近平重要讲话数据库
cpc.people.com.cn	人民网
opinion.people.com.cn	人民网
finance.people.com.cn	人民网
theory.people.com.cn	人民网
dangshi.people.com.cn	人民网
dangjian.people.com.cn	人民网
www.jjckb.cn	经济参考网
www.cankaoxiaoxi.com	参考消息网
www.ce.cn	中国经济网
www.sgcctop.com	电网头条
ee.sem.tsinghua.edu.cn	清华经管课程
zdpx.zju.edu.cn	浙江大学继续教育学院课程
xm.sce.tsinghua.edu.cn	清华大学继续教育学院
www.cntheory.com	中央党校理论网
sce.ruc.edu.cn	中国人民大学继续教育学院
mp.weixin.qq.com	党校公开课
fileSystem	内部资料
www.chinagwy.org	公考资讯网
www.sgcc.com.cn	国家电网
www.12371.cn	共产党员网
www.news.cn	新华网
cn.chinadaily.com.cn	中国日报网
www.rmzixun.cn	人民资讯
www.163.com	网易
www.cpnn.com.cn	中国能源新闻网
www.chinapower.com.cn	电力网
www.xuexi.cn	学习强国
www.toutiao.com	今日头条
www.thepaper.cn	澎湃新闻
www.sohu.com	搜狐网
zqb.cyol.com	中国青年报
www.cyol.com	中青在线
cec.org.cn	中国电力企业联合会
www.ndrc.gov.cn	发改委网站
news.163.com	网易
it.sohu.com	搜狐网
tech.163.com	网易
www.gov.cn	政府网站
news.sina.com.cn	新浪网
www.sasac.gov.cn	国资委网站
www.ccps.gov.cn	中共中央党校
www.nea.gov.cn	国家能源局
tech.sina.com.cn	新浪网
